NO textures/simonkraft/respawn_anchor_side0.xpm
EA textures/simonkraft/respawn_anchor_side2.xpm
SO textures/simonkraft/respawn_anchor_side4.xpm
WE textures/simonkraft/respawn_anchor_side3.xpm

C 6,6,66
F 128,0,0

11111111111111111111111111
11111111111111111111111111
11111000001111110000011111
11110000000111100000001111
11100000000011000000000111
11000000000000000000000011
11100000000000000000000111
11111000000000000000011111
11111111000000000011111111
11111111110000000111111111
1111111111110N011111111111
11111111111111111111111111

